0 0 0 0 0 0 0
0 0 0 0 7 7 0
0 1 0 2 7 7 0
0 0 0 0 7 7 0
0 0 0 0 7 7 0
