0 0 1 7 2 0 0
0 7 0 7 7 0 0
7 7 7 7 7 7 7
0 0 0 7 0 4 0
0 7 3 7 7 0 7