7 7 7 7 7 7 7
7 7 7 0 7 7 7
7 7 0 9 0 7 7
7 0 9 0 9 0 7
1 0 0 0 0 0 2
