0 0 0 0 0 0 9
0 0 0 0 0 0 9
0 0 0 0 0 0 9
0 0 0 0 0 3 7
0 0 0 7 1 2 7
