7 7 0 0 0 7 7
7 7 0 0 1 7 7
7 7 0 2 0 0 0
7 7 3 0 9 7 7
0 0 0 0 0 7 7