7 7 7 0 0 7 7
7 0 9 1 9 7 7
7 0 0 0 0 0 7
7 7 9 2 9 0 7
7 7 0 0 7 7 7
