0 7 0 0 0 7 0
0 0 7 1 9 0 0
0 0 2 7 3 0 0
0 0 9 4 7 0 0
0 7 0 0 0 7 0