0 7 0 7 0 0 0
0 0 0 7 0 0 7
1 0 0 7 0 0 3
2 0 7 0 0 7 4
0 0 0 7 0 7 0
