7 7 7 7 7 7 7
7 7 0 7 7 7 7
0 0 0 1 2 3 4
7 7 7 0 7 0 7
7 7 7 7 7 7 7