0 0 0 0 0 0 0
0 1 0 9 0 2 0
7 0 0 9 0 0 7
7 3 0 9 0 4 0
0 0 0 7 0 0 0