1 0 9 0 9 0 2
0 0 7 0 7 0 0
0 7 7 7 7 7 0
0 7 0 7 0 7 0
3 0 0 0 0 0 4
