0 1 0 7 0 2 7
0 9 9 3 9 9 0
7 0 0 7 0 0 0
7 0 0 0 0 0 7
7 0 0 0 0 0 7
