0 0 0 7 9 1 7
0 0 0 0 0 9 7
0 0 0 0 0 0 7
0 0 7 9 0 0 7
0 7 7 2 0 0 7
