7 0 0 0 0 0 7
7 7 0 0 0 0 7
9 7 0 0 0 7 1
9 0 0 0 0 0 2
9 0 0 0 0 0 3
