9 0 0 9 0 0 9
0 0 7 1 7 0 0
0 7 0 2 0 7 0
7 0 0 3 0 0 7
0 0 0 4 0 0 0