9 0 0 0 0 9 0
9 0 0 0 0 0 0
9 1 0 2 0 3 0
0 0 7 0 7 0 0
0 9 9 9 0 0 0
