0 0 0 0 7 7 7
0 0 9 0 9 7 7
7 0 1 9 2 0 7
7 7 9 0 9 0 0
7 7 7 0 0 0 0