1 3 0 0 0 0 7
7 7 7 7 7 9 0
0 0 7 0 7 9 0
4 2 0 0 0 9 0
7 7 0 7 7 0 7
