0 0 0 7 0 7 0
0 0 0 0 0 0 0
0 0 7 0 4 1 0
7 0 0 0 2 3 0
0 0 0 0 0 0 0
