0 0 0 2 0 0 0
0 0 0 9 7 0 0
7 7 7 9 7 7 7
0 0 7 9 0 0 0
0 0 0 1 0 0 0
