0 7 1 0 2 7 0
0 0 3 0 4 0 0
7 0 9 0 9 0 7
0 0 0 0 0 0 0
0 0 0 0 0 0 0