0 0 0 0 0 0 0
0 0 7 9 1 0 0
0 0 7 2 3 0 0
0 0 0 0 0 0 0
0 0 0 0 0 0 0