7 0 9 9 9 7 0
0 0 0 0 0 0 0
0 7 0 0 0 7 0
0 0 0 0 0 0 0
0 7 1 0 2 7 7
