0 0 0 0 0 0 0
0 7 9 9 9 0 0
0 0 1 2 3 0 0
0 0 0 0 0 0 0
0 0 0 0 0 0 0