9 9 0 0 0 0 0
1 2 0 0 0 0 0
7 7 0 0 0 0 0
0 0 7 0 0 0 0
0 3 7 0 0 0 0
