0 9 0 0 0 0 7
0 9 0 0 0 1 7
0 0 0 0 0 2 0
0 9 0 0 0 3 7
0 9 0 0 0 0 7