0 0 0 0 0 0 0
0 7 0 7 0 7 0
1 0 2 0 3 0 4
0 7 0 7 0 7 0
0 0 0 0 0 0 0
