7 7 7 7 7 7 7
7 7 0 7 7 7 7
0 0 9 9 1 0 0
7 0 9 9 2 0 0
7 7 7 7 7 7 7