7 7 7 2 7 7 7
0 1 5 0 5 3 0
0 7 7 7 7 0 0
0 0 0 0 7 0 0
7 0 0 0 7 0 0
