0 0 1 0 2 0 0
0 0 0 0 0 0 0
0 0 9 7 9 0 0
0 0 0 9 0 0 0
0 0 0 3 0 0 0
