0 0 1 2 3 0 0
0 0 9 0 9 0 0
0 7 7 7 7 7 0
0 0 0 7 0 0 0
7 0 0 7 0 0 0
