0 0 0 0 0 0 0
0 7 1 0 2 0 0
0 0 0 0 0 0 0
0 7 3 0 4 0 0
0 0 0 0 0 0 0