7 0 0 0 0 0 0
7 0 7 1 7 0 0
0 0 9 9 9 0 0
0 0 7 2 7 0 0
0 0 0 0 0 0 0