7 0 0 0 1 9 0
7 7 0 0 0 9 9
7 7 7 0 0 0 2
7 7 7 7 0 0 0
7 7 7 7 7 0 0